111111111111111111111111111111111111111111111111111111111
100000000000000000011111110000000000000001111111100000001
100011111110000000011111110000000000000001111111100000001
100011111110000000011111110000111111100001111111100000001
100011111110000000000000000000111111100001111111100000001
100000000000000000000000000000111111100000000000000000001
100000000001111111001111111000111111100000000000000000001
111111110001111111001111111000000000000000000000000111111
111111110001111111001111111000000000000000000000000111111
111111110000000000000000000000111111111111111100000111111
100000000000000000111111100000111111111111111100000000001
100000001111111000111111100000111111111111111100000000001
111110001111111000111111100000000000000000000000000000001
1111100011111110000000000000P0000000000011111110000111111
111110000000000000000000001111111000000011111110000111111
100000000000000001111111001111111000000011111110000111111
100000011111110001111111001111111000000000000000000000001
11111001111111000111111100111111100C000000000000000000001
100000011111110000000000000000000000000000000000001111111
100000000000000000000000000000000000000011111110001111111
11110000000000001111111000C000000000000011111110001111111
111100111111100011111110001111111000000011111110001111111
111100111111100011111110001111111000000000000000001111111
10000011111110000000000000111111100C000000000000001111111
10000000000000000000000000111111100000000000000000C000001
100111111100001111111100000000000000000011111110101111111
100111111100001111111100001111111000000011111110100000001
1001111111000011111111000011111110000000111111101111000E1
111111111111111111111111111111111111111111111111111111111
