1111111111111111111111111
1111111111111111111111111
11111111CCCCCCCCC11111111
1PCCCCCCCCCCCCCCCCCCCCCE1
11111111CCCCCCCCC11111111
1111111111111111111111111
1111111111111111111111111
