1111111111111111111
10000C0000000000001
11111111C1C11111111
10100000010000000E1
10001C1100011011111
1111101111111011111
1P00001111111000001
1011111111111111111
1C000000000000000C1
10111111C1C11111101
1010000001000000101
1000101100011010001
1111101111111011111
10000C1111111000001
1011111111111111111
1000C000000000000C1
1011111101011111101
1010000001000000101
10001011C0011010001
11111C1111111011111
1100001111111000001
1111111111111111111
