11111111111111111111
1C0001C000000C100001
10110101111110101E01
10100000000000000101
101C110111111011C101
1010110111111C110101
1C0000000P0000000101
111010111111C1011101
1C0010C0000001C000C1
11111111111111111111
