111111111111111111111111111111111111111111111111111111111111
10000000C000000C00000010000000000000110000110000000000000001
10000000C00000C000000C00000010000110110110110111110C1111C001
100000000000000000000000000000000110110110110110000000000001
100000000000000000000000000000000110110110110111111111111101
100000000000000000000000000000100110110110110110000000000001
100000000000000000000000000000000110110110110110111111111111
1000000000000000000000000000000001101101101101101000100011E1
100000000000000000000000000000000110110110110110101000100101
111111110000000000000000000000000110110110110110101111111111
100010010000000000000000000000000110110110110110100000000001
101000010000000000000000000000000110110110110110111111111101
1P1001000000000000000000000000000110000110000110000000000001
111111111111111111111111111111111111111111111111111111111111
