11111111
101C10E1
1P101101
1000C001
11111111
