11111111
100C10E1
1P001101
1000C001
11111111
