11111111
1hldkhP1
1Ciojdv1
1Ejyoij1
11111111
